######################################################
##                                                  ##
##    @                                             ##
##                                                  ##
##                                                  ##
##                                                  ##
##                   $                              ##
##                                                  ##
##                                                  ##
##                                                  ##
##                                                  ##
##                                                  ##
######################################################